111111111
1P0100111
100C101E1
101111101
10C00C101
101111101
10001C001
111000011
111111111