1111111111111
1P0001001E111
11100C1010C11
1000111110111
1C10C00C101C1
1110111110001
1C000C1C00111
1111000001111
1111111111111