1111111111111111111
1000000000000000001
1111000000000000001
1C01000000P00000001
10000000000000000E1
1111000000000000001
1CC0000000000000001
1111111111111111111