1111111111111111111
1000000000000000001
1111000000000000001
1C01000000000000001
10000000000000000E1
11110000000000000P1
1C00000000000000001
1111111111111111111