1111111111
100000C001
1011111011
1010001001
1010111111
1000000C01
1111111011
10000P0001
1011111111
10C00000E1
1111111111