111111111111111111111111111111111111111111111111111
100P000000000000000000C0C000000000000000000000000E1
1000000000000X000C000000000000000000000000000000001
100000000000000000000000000000000000000000000000001
100000000000000000000000000000000000000000000000001
100000000000000000000000000000000000000000000000001
100000000000000000000000000000000000000000000000001
111111111111111111111111111111111111111111111111111