1111111111111
1X00P0011E111
11110C1010C11
1000011110111
1C10C00C101C1
1110111110001
1C000C1C00111
1111000001111
1111111111111