1111111111111
1P000001X00C1
1011101011101
1C0000X000C01
1110111010111
1C000C00000C1
101X10X111101
1C000C00000C1
1110111010111
1C000001C00X1
1011101011101
1C0000C0000E1
1111111111111