111111111111111111111
1000000X00000X00000E1
100000000000CCCCC0001
1P0000000000000000001
111111111111111111111