111111111111111111111
1X0P00C000000000000E1
111111111111111111111